11111111111111111111111111111111111111111111111111111111111
1P00000000C000000000000000000000000000000000000000000000001
10000000000000000000000000000000000000000000000000000000001
10011100111001000011000110001110001000100011100011000110001
10010000100001000010101010010001001000100100010010101010001
10011100111001000010010010010001001111100111110010010010001
10010000100001000010000010010001001000100100010010000010001
10011100111001110010000010001110001000100100010010000010001
100000000000000000000000000C0000000000000000000000000000001
10000000000000000000000000000000C00000000000000000000000001
10000000001111001111100111110011111000000000000000000000001
10000000000001000000100000010000001000000000000000000000001
1000000000000100000010000C0100000010000000000000C0000000001
10000000000001001111100111110000001000000000000000000000001
1000000000000100000010000C0100000010000000000000C0000000001
10000000000001000000100000010000001000000000000000000000001
10000000000001001111100111110000001000000000000000000000001
1000000C000000000000000000000000000000000000000000000000001
100000000000000000000000000000000000000000000010000000000E1
11111111111111111111111111111111111111111111111111111111111
