11111111111111111111111111111
1P0C0000000000000000000000001
10000000011110000000000000001
10000100000000000000000000001
10000000001000001000000000001
10000100001000C01000000000001
10000000001000001000000000001
10011111111101111000000000001
100000C0001000001000E00000001
10011111111000001000000000001
10010000001001001000000000001
10000001001000011000000000001
100000X0000000100000000000001
11111111111111111111111111111